1111111
10XX001
1PC0CE1
1111111