1111111111111111111111111111111111
1E00000000X000C00000C0000000000011
1010010100100000101001000000010101
1010010010101010001001000000010101
1P0000X00C00C00000X0000001000000C1
1111111111111111111111111111111111