111111
1P00C1
1000C1
111111
1E0011
111111