11111
1P111
111C1
111E1
11111
