111111
1P0C01
111011
1C0E11
111111