111111
1P0C11
1C0011
1100E1
111111